10 10
__ __ __ __ __ __ __ __ __ __
__ O1 O1 __ __ __ __ __ __ __
__ O1 O1 __ __ __ __ __ __ __
__ __ __ __ __ __ __ __ __ __
__ __ O0 __ __ __ __ __ __ __
__ __ O0 __ __ __ __ __ E0 __
__ __ O0 E0 __ O0 O0 O0 O0 O0
P0 __ O0 O0 O0 O0 O0 O0 O0 O0
O0 O0 O0 O1 O1 O1 O1 O1 O1 O0
O0 O0 O1 O1 O1 O1 O1 O1 O1 O1